{
    "room_name": "Hello world!",
    "width": 20,
    "height": 20,
    "tilesets": ["grass_01"],
    "tileGroupKeys": ["G", "R"],
    "tileGroups": {
        "G": [
            "grass_0","grass_1","grass_2","grass_3","grass_4","grass_5","grass_6","grass_7","grass_8","grass_9","grass_10","grass_11","grass_12","grass_13"
        ],
        "R": [
            "road_0","road_1","road_2","road_3","road_4","road_5","road_6","road_7","road_8","road_9","road_10","road_11","road_12","road_13","road_14"
        ]
    },
    "tileLayout": [
        ["G","G","G","G","G","G","G","G","G","G","G","G","G","G","G","R","R","G","G","G"],
        ["G","G","G","G","G","G","G","G","G","G","G","G","G","G","G","R","R","G","G","G"],
        ["G","G","G","G","G","G","G","G","G","G","G","G","G","G","G","R","R","G","G","G"],
        ["G","G","G","G","G","G","G","G","G","G","G","G","G","G","G","R","R","G","G","G"],
        ["G","G","G","G","G","G","G","G","G","G","G","G","G","G","G","R","R","G","G","G"],
        ["G","G","G","G","G","G","G","G","G","G","G","G","G","G","G","R","R","G","G","G"],
        ["G","G","G","G","G","G","G","G","G","G","G","G","G","G","G","R","R","G","G","G"],
        ["G","G","G","G","G","G","G","G","G","G","G","R","R","R","R","R","G","G","G","G"],
        ["G","G","G","G","G","G","G","G","G","R","R","R","R","R","R","G","G","G","G","G"],
        ["R","R","R","R","R","R","R","R","R","R","G","G","G","G","G","G","G","G","G","G"],
        ["R","R","R","R","R","R","R","R","R","G","G","G","G","G","G","G","G","G","G","G"],
        ["G","G","G","G","G","G","G","G","G","G","G","G","G","G","G","G","G","G","G","G"],
        ["G","G","G","G","G","G","G","G","G","G","G","G","G","G","G","G","G","G","G","G"],
        ["G","G","G","G","G","G","G","G","G","G","G","G","G","G","G","G","G","G","G","G"],
        ["G","G","G","G","G","G","G","G","G","G","G","G","G","G","G","G","G","G","G","G"],
        ["G","G","G","G","G","G","G","G","G","G","G","G","G","G","G","G","G","G","G","G"],
        ["G","G","G","G","G","G","G","G","G","G","G","G","G","G","G","G","G","G","G","G"],
        ["G","G","G","G","G","G","G","G","G","G","G","G","G","G","G","G","G","G","G","G"],
        ["G","G","G","G","G","G","G","G","G","G","G","G","G","G","G","G","G","G","G","G"],
        ["G","G","G","G","G","G","G","G","G","G","G","G","G","G","G","G","G","G","G","G"]
    ],
    "barrierLayout": [
        [0,0,0,0,0,0,0,0,0,0,0,0,0,0,0,0,0,0,0,0],
        [0,0,0,0,0,0,0,0,0,0,0,0,0,0,0,0,0,0,0,0],
        [0,0,0,0,0,0,0,0,1,0,0,0,0,0,0,0,0,0,0,0],
        [0,0,0,0,0,0,0,0,0,0,1,0,0,0,0,0,0,0,0,0],
        [0,0,0,0,0,0,0,0,0,0,0,0,0,0,0,0,0,0,0,0],
        [0,0,0,0,0,0,0,0,0,0,0,0,0,0,0,0,0,0,0,0],
        [0,0,0,0,0,0,0,0,0,0,0,0,0,0,0,0,0,0,0,0],
        [0,0,0,0,0,0,0,0,0,0,0,0,0,0,0,0,0,0,0,0],
        [0,0,0,0,0,0,0,0,0,0,0,0,0,0,0,0,0,0,0,0],
        [0,0,0,0,0,0,0,0,0,0,0,0,0,0,0,0,0,0,0,0],
        [0,0,0,0,0,0,0,0,0,0,0,0,0,0,0,0,0,0,0,0],
        [0,0,0,0,0,0,0,0,0,0,0,0,0,0,0,0,0,0,0,0],
        [0,0,0,0,0,0,0,0,0,0,0,0,0,0,0,0,0,0,0,0],
        [0,0,0,0,0,0,0,0,0,0,0,0,0,0,0,0,0,0,0,0],
        [0,0,0,0,0,0,0,0,0,0,0,0,0,0,0,0,0,0,0,0],
        [0,0,0,0,0,0,0,0,0,0,0,0,0,0,0,0,0,0,0,0],
        [0,0,0,0,0,0,0,0,0,0,0,0,0,0,0,1,0,0,0,0],
        [0,0,0,0,0,1,0,0,1,1,0,0,0,1,1,1,1,0,0,0],
        [0,1,1,1,1,1,1,1,1,1,1,1,1,1,1,1,1,1,1,1],
        [1,1,1,1,1,1,1,1,1,1,1,1,1,1,1,1,1,1,1,1]
    ],
    "objectSets": ["trees_01"],
    "objectGroupKeys": ["T"],
    "objectGroups": {
        "T": ["tree_1", "tree_2", "tree_3"]
    },
    "objectLayout": [
        ["-","-","-","-","-","-","-","-","-","-","-","-","-","-","-","-","-","-","-","-"],
        ["-","-","-","-","-","-","-","-","-","-","-","-","-","-","-","-","-","-","-","-"],
        ["-","-","-","-","-","-","-","-","T","-","-","-","-","-","-","-","-","-","-","-"],
        ["-","-","-","-","-","-","-","-","-","-","T","-","-","-","-","-","-","-","-","-"],
        ["-","-","-","-","-","-","-","-","-","-","-","-","-","-","-","-","-","-","-","-"],
        ["-","-","-","-","-","-","-","-","-","-","-","-","-","-","-","-","-","-","-","-"],
        ["-","-","-","-","-","-","-","-","-","-","-","-","-","-","-","-","-","-","-","-"],
        ["-","-","-","-","-","-","-","-","-","-","-","-","-","-","-","-","-","-","-","-"],
        ["-","-","-","-","-","-","-","-","-","-","-","-","-","-","-","-","-","-","-","-"],
        ["-","-","-","-","-","-","-","-","-","-","-","-","-","-","-","-","-","-","-","-"],
        ["-","-","-","-","-","-","-","-","-","-","-","-","-","-","-","-","-","-","-","-"],
        ["-","-","-","-","-","-","-","-","-","-","-","-","-","-","-","-","-","-","-","-"],
        ["-","-","-","-","-","-","-","-","-","-","-","-","-","-","-","-","-","-","-","-"],
        ["-","-","-","-","-","-","-","-","-","-","-","-","-","-","-","-","-","-","-","-"],
        ["-","-","-","-","-","-","-","-","-","-","-","-","-","-","-","-","-","-","-","-"],
        ["-","-","-","-","-","-","-","-","-","-","-","-","-","-","-","-","-","-","-","-"],
        ["-","-","-","-","-","-","-","-","-","-","-","-","-","-","-","T","-","-","-","-"],
        ["-","-","-","-","-","T","-","-","T","T","-","-","-","T","T","T","T","-","-","-"],
        ["-","T","T","T","T","T","T","T","T","T","T","T","T","T","T","T","T","T","T","T"],
        ["T","T","T","T","T","T","T","T","T","T","T","T","T","T","T","T","T","T","T","T"]
    ]
}